#.##....s.##.....#.##.
..........#.#....#.##.
#..#.#....####....#..#
......#.........#....#
#..#.#........#...##.#
##....#...###.....#..#
.#....##.##.#..####...
...#.#.#.........##...
.#...##.##..#.....####
##.#..#.#.....#.#...#.
...#...#.###...#.###.#
#.....#.##..#.......##
#.#...###..##.........
......###.....#.......
..#......#.##.#.......
.#....#.......#.....##
.##.#...#......#.#.##.
.#.....#........##..#.
..###..##..#...###....
.......####.#....#..##
.......#......#.#...##
..#.##..#..##.....#...
....######..#.#..#...#
.#...#....#..#.......#
#...##.f..#....####...
....#.#....#.###.#...#
#.#.##..##.......##..#
#..#......##..##....#.
...##.###...#..##..###
...##....#..#.....##..
