.#...........#.#...#...#.......#....##...#.......
..#.....##.......#.........#.#...........#.......
#.......#....#...#...##......#.#.....##...#...#.#
...........#.......#..#.#...##.#...##.#.....##..#
.........#.#...............................##..#.
.......#..#....#..##.....f#......##....##........
...#.....#........#..........#...#..##......#.#..
.........#....#.........#.#..#...#..#.........#.#
................###...#......#......#......##....
.#....................#.##.#..#..#.......#.#....#
.....##........#.....#...#.#..#.....#..........#.
.#............................#....#...#.......#.
......#................#...#...#.....#.......#...
##.#....#.....##....#.#.....#......#...........#.
..#........##........#.#...#.#...........#.#.....
....#.......#.#.#.#.....#............#.#....#...#
#.......#...#..#...............#..#.......#......
.##.............#...........#......##............
....#..#..#..#.#...............#...#...#........#
.............#.......##......#..#.#.#.......#....
......#....#.###.#.....#.....................#..#
#.##..#..#......#........#........#...........#..
...#....................#.....#..#.............##
.......#.....#.#.###.............#.##....##.#..#.
...................#....##.........#.#..#......#.
.........#.#..#...#................#.##.........#
#..#.........#.....#...........#.#...#s...#..#...
.....##.#.#.........#.......#..#.#........##.....
..###..#.....#.#...#........##....##........#.#..
.........#.##...................................#
